9
0 3 3 1 5 4 1 5 1
5 0 2 1 1 1 5 3 -1
4 2 0 4 2 3 4 3 -1
4 3 3 0 4 2 1 3 4
-1 2 4 1 0 1 -1 4 1
2 -1 -1 4 2 0 5 2 3
-1 4 1 -1 -1 2 0 2 -1
2 5 3 3 -1 1 2 0 2
4 -1 4 4 1 1 -1 -1 0
